"a" = (/area/simple,/turf/floor)
"b" = (/area/simple,/turf/floor/yellow,/obj/item)
"c" = (/area/simple,/turf/floor{color = "red"},/obj/item{alpha = 128})
"d" = (/area/simple{alpha = 0},/turf/floor)

(1,1,1) = {"
aaaad
abaaa
aaaaa
aaaca
aaaaa
"}