"a" = (/turf/simple)
"b" = (/turf/simple,/obj/item)

(1,1,1) = {"
aaaaa
ababa
aaaaa
"}