"a" = (/obj/item)
"b" = (/obj/item{var1 = 1; var2 = "custom value"})

(1,1,1) = {"
ab
ba
"}