//MAP CONVERTED BY dmm2tgm.py THIS HEADER COMMENT PREVENTS RECONVERSION, DO NOT REMOVE
"a" = (
/turf/simple)
"b" = (
/turf/simple{
	icon_state = "turf";
	dir = 1
	},
/obj/item)
"c" = (
/turf/simple{
	contents = newlist(/obj/item,/obj/item/weapon)
	},
/obj/item)

(1,1,1) = {"
a
a
a
"}
(2,1,1) = {"
a
b
c
"}
(3,1,1) = {"
a
a
a
"}